109,110,109,110,109,110,109,110,110,110,110,110,109,109,109,109,110,109,109,109,109,109,110,110,110,110,109,110,109,110,
142,143,142,143,109,110,142,109,110,109,110,109,109,109,109,109,109,110,109,109,110,109,109,110,109,109,142,143,142,143,
109,110,109,110,142,143,142,109,109,110,110,109,109,110,110,109,109,109,109,110,109,110,142,143,110,109,110,142,143,142,
142,143,142,143,110,109,109,142,142,143,143,142,142,143,143,109,110,142,142,143,142,143,143,142,143,142,109,110,110,142,
109,110,109,142,143,142,142,109,142,143,142,109,109,110,142,142,143,143,110,143,142,142,142,109,110,143,142,143,143,109,
142,143,142,143,142,143,110,142,109,110,110,142,142,143,110,142,143,142,109,109,110,143,143,109,110,143,142,143,110,142,
109,110,109,110,109,142,143,143,142,109,110,143,109,109,110,109,110,143,142,142,143,142,143,142,143,109,110,142,143,142,
142,109,110,143,109,110,110,109,109,142,143,142,142,142,143,142,143,142,142,143,142,143,142,109,109,142,143,142,143,28,
54,142,143,142,142,143,109,109,109,110,109,109,110,109,109,110,109,109,109,109,110,110,109,142,142,142,143,28,28,28,
38,28,28,28,142,143,142,109,142,143,109,142,143,109,110,110,109,109,142,142,143,143,109,110,143,39,39,38,38,39,
38,38,38,39,38,38,39,142,109,109,109,110,143,142,143,143,109,110,142,109,109,109,110,143,38,39,38,38,38,39,
38,39,39,39,39,39,38,39,142,142,142,143,109,142,109,110,142,143,109,109,109,142,143,38,39,38,39,38,38,45,
38,39,39,39,39,39,39,39,39,142,109,109,142,143,142,143,110,109,110,142,142,143,38,39,38,39,39,45,45,39,
38,39,39,28,39,39,38,39,39,39,142,142,109,109,109,142,143,142,143,142,143,38,39,38,39,54,39,45,38,39,
38,39,28,39,39,39,38,39,39,38,39,39,142,142,142,142,142,142,143,38,38,38,38,45,45,45,54,38,38,39,
39,39,28,28,39,39,39,39,39,39,39,38,38,38,38,38,38,38,38,38,38,38,45,45,39,28,54,39,38,39,
45,45,39,38,38,38,45,45,38,38,38,38,38,38,44,44,44,44,44,44,45,45,45,39,38,45,45,45,38,39,
45,39,39,38,38,39,39,45,39,39,39,38,38,38,38,38,38,39,39,45,45,38,38,38,38,39,45,45,38,39,
38,39,38,38,38,39,38,45,38,38,38,44,44,39,39,39,39,39,39,45,38,39,38,38,39,39,44,38,38,39,
38,39,45,45,38,38,45,45,45,39,44,44,39,39,38,39,39,39,38,39,39,38,38,45,39,39,44,44,39,39,
54,55,45,45,39,38,45,39,45,45,44,38,54,39,39,39,39,54,38,38,38,38,39,39,39,45,45,38,54,55,
54,55,54,55,39,38,38,45,38,45,45,54,38,54,54,54,54,38,54,38,38,38,39,39,44,44,54,55,54,55,
54,55,54,55,54,55,45,45,38,38,38,38,38,38,45,39,39,45,39,38,38,39,45,45,54,55,54,55,54,55,
54,55,27,55,54,55,54,55,45,44,38,44,38,38,39,39,44,44,39,38,39,38,54,55,54,55,54,55,54,55,
54,54,27,55,54,55,54,55,54,55,39,44,45,44,44,45,39,39,39,38,54,55,54,55,54,55,54,55,54,55,
27,27,27,27,27,55,27,27,54,55,54,55,38,39,39,39,39,44,54,55,54,55,54,55,54,55,54,55,54,55,
54,55,54,27,27,54,54,27,54,55,54,55,54,54,54,55,54,55,54,55,54,55,54,55,27,27,27,27,27,27,
27,27,27,27,27,27,54,54,27,27,54,54,54,54,54,54,54,54,54,54,54,54,54,27,27,27,27,27,55,27,
54,54,27,27,27,27,27,55,55,27,55,55,55,55,55,55,55,55,55,27,27,27,27,27,55,55,55,55,27,27,
54,54,54,54,27,27,27,27,27,27,27,27,27,27,27,27,27,27,27,27,55,27,27,54,54,54,27,27,27,55,
