27,1,2,27,60,60,1,1,60,60,60,60,60,60,60,60,60,60,60,60,60,60,60,27,27,27,27,1,2,29,
29,29,27,27,27,27,27,27,1,27,27,27,27,1,2,27,27,27,27,28,29,28,29,27,27,27,27,27,27,27,
27,27,27,27,27,27,27,27,27,27,27,27,27,28,29,1,1,27,28,29,29,27,27,27,28,29,28,29,1,60,
60,60,60,60,60,60,27,27,27,27,27,27,27,27,27,27,27,27,27,27,28,29,28,29,29,29,27,27,27,27,
62,27,27,27,27,27,60,60,60,60,60,60,60,60,60,60,60,60,60,27,27,27,27,27,27,27,27,27,27,27,
29,60,60,60,60,60,61,62,29,29,27,27,27,27,27,27,27,27,27,60,27,27,27,27,27,27,27,27,27,27,
62,62,27,27,27,27,27,27,27,27,27,27,60,60,27,27,27,27,27,27,60,60,60,60,60,60,60,60,60,60,
27,27,27,27,31,32,32,34,35,60,27,27,27,27,60,60,60,60,60,27,27,27,27,27,27,27,27,27,27,27,
27,27,60,42,43,45,44,46,27,27,60,60,60,60,60,27,27,27,27,42,43,45,45,46,47,60,60,60,27,28,
60,60,60,48,49,38,39,52,53,60,27,27,27,27,27,27,27,27,27,48,49,45,45,52,29,29,27,27,28,29,
61,62,29,29,42,43,40,41,27,27,60,60,60,27,27,27,27,27,27,28,42,43,46,47,27,27,27,27,27,27,
61,62,27,27,42,43,46,47,27,27,27,27,27,60,60,60,60,60,60,28,42,43,46,47,27,27,60,60,60,27,
27,27,60,60,42,43,46,47,60,60,60,27,27,27,27,27,27,27,27,28,42,43,46,47,27,27,27,28,29,28,
60,60,27,27,36,37,40,41,27,27,27,27,60,60,60,60,60,60,60,28,42,43,46,47,60,60,27,27,27,28,
60,61,60,27,36,37,39,34,35,60,27,27,27,28,29,27,27,60,60,28,31,38,39,34,35,29,60,60,27,28,
27,27,27,27,42,43,38,39,32,33,32,33,33,32,32,32,32,32,32,32,45,38,39,39,33,33,33,33,33,32,
60,60,27,27,42,43,38,38,38,38,38,38,38,39,38,38,38,38,38,38,38,39,38,38,38,38,38,38,38,38,
27,27,60,60,60,49,50,51,50,51,50,51,50,45,38,39,38,51,50,51,51,51,50,50,50,50,50,51,51,51,
27,27,27,27,27,27,27,27,27,60,60,60,48,49,38,39,52,27,27,27,27,27,27,27,27,27,27,28,29,29,
60,27,27,27,27,60,60,60,60,61,62,27,27,36,37,40,41,27,27,27,27,28,29,27,27,27,28,29,27,28,
27,60,60,60,60,60,61,62,29,27,27,60,60,42,43,46,47,60,27,60,27,28,29,60,60,27,28,29,27,28,
60,60,61,62,29,29,27,27,27,60,60,60,27,42,43,46,47,27,60,27,28,29,29,60,61,27,28,29,27,28,
62,27,27,27,27,28,29,60,60,27,27,28,29,36,37,46,47,60,27,28,29,29,62,62,27,28,29,29,27,27,
27,28,29,27,28,29,29,27,27,60,27,27,28,36,37,40,41,27,28,29,29,62,62,60,27,28,29,62,27,28,
60,61,62,29,29,29,62,60,60,61,60,27,28,42,43,46,47,28,29,29,62,62,27,27,28,29,29,60,27,28,
61,62,62,62,62,62,27,27,28,29,27,27,27,36,37,46,47,29,62,62,61,27,28,29,29,29,62,62,27,28,
27,27,60,60,27,28,29,29,29,29,60,27,28,36,37,46,47,27,28,29,29,29,29,29,62,62,27,28,29,29,
29,29,29,29,29,29,62,62,62,62,29,29,29,36,37,46,47,27,28,29,29,62,62,62,29,29,29,29,29,62,
62,62,62,62,62,62,29,29,29,29,29,62,62,36,37,40,41,27,28,29,62,60,61,62,62,62,62,62,62,62,
61,62,62,62,62,62,62,62,62,62,62,62,62,36,37,46,47,29,29,29,29,29,62,62,60,61,62,62,62,29,
