26,26,1,1,2,26,26,26,26,26,26,26,26,26,2,26,26,26,26,26,26,26,26,1,2,26,26,26,26,26,
59,59,59,1,2,59,26,26,2,2,2,26,26,26,26,26,26,26,26,26,26,26,26,26,26,26,26,26,26,26,
26,26,26,26,26,26,26,26,26,26,26,26,26,26,26,26,59,1,2,59,59,59,59,59,59,59,59,59,26,27,
26,26,26,26,26,59,59,59,59,59,59,59,59,59,59,59,60,61,62,27,28,29,29,26,2,26,26,26,26,26,
26,26,26,26,26,26,26,26,26,26,26,26,26,26,2,26,26,26,26,26,26,26,2,2,59,59,59,59,59,59,
59,59,59,59,59,59,59,59,59,59,59,59,59,59,2,59,59,59,59,59,59,59,59,60,61,62,62,62,62,62,
62,29,29,29,29,29,29,29,29,26,26,26,26,26,26,26,26,26,26,26,26,26,26,26,26,26,26,26,26,26,
26,26,26,26,26,26,26,26,26,59,59,59,59,59,59,59,59,59,59,59,59,59,59,59,59,59,59,59,59,59,
59,59,59,59,59,59,59,59,59,60,61,62,62,62,26,26,26,26,26,26,26,26,26,26,26,26,27,28,29,29,
26,26,26,26,26,26,26,26,26,26,26,26,26,26,59,59,59,59,26,27,28,29,29,29,29,29,29,29,29,62,
59,59,59,59,59,59,59,26,27,28,29,29,29,29,29,29,29,29,29,29,29,62,62,62,26,26,26,26,26,26,
29,29,29,29,29,29,29,29,29,29,62,62,62,62,62,26,26,26,26,26,26,26,26,26,59,26,27,28,29,29,
26,26,26,26,26,26,26,26,26,26,26,26,26,26,26,59,59,59,26,27,28,26,26,26,26,26,26,26,26,26,
26,26,26,26,26,26,26,26,26,26,26,26,26,26,26,26,26,26,26,26,26,59,59,59,59,26,27,28,26,27,
59,59,59,59,59,59,59,59,59,59,59,59,59,59,59,59,59,59,59,59,26,26,27,28,29,29,29,29,29,26,
32,32,33,33,33,32,33,34,35,26,26,26,26,26,26,26,26,26,26,26,26,26,26,26,26,26,26,26,26,27,
44,38,38,38,38,38,38,40,41,59,59,59,59,59,59,59,59,59,59,59,59,59,59,59,26,27,28,29,29,29,
50,51,50,51,51,50,51,52,59,60,61,62,29,29,29,29,29,29,26,27,28,29,29,29,29,29,29,62,26,27,
62,62,62,62,62,62,62,62,62,62,62,26,27,28,29,29,29,29,29,29,29,62,62,26,27,28,29,29,29,29,
26,27,28,29,29,29,29,29,29,29,29,29,29,29,62,62,62,26,27,28,29,29,29,29,29,29,62,62,62,62,
59,26,26,26,26,26,26,26,26,26,26,27,28,29,29,29,29,29,29,29,62,62,62,62,62,62,61,62,26,26,
26,27,28,29,29,29,29,29,29,29,29,29,29,62,62,62,62,62,62,62,26,26,26,26,26,26,26,26,27,28,
29,29,29,62,62,62,62,62,62,62,26,26,26,26,26,26,26,26,26,26,59,59,59,59,26,27,26,26,26,26,
26,26,26,26,26,26,26,26,26,26,26,26,26,26,26,26,26,26,26,26,26,26,26,26,26,26,59,59,59,59,
26,26,26,59,59,59,59,59,59,59,59,59,59,59,59,26,26,26,26,26,26,26,26,27,28,29,29,61,26,27,
59,59,59,60,61,62,26,26,26,26,26,26,26,26,26,59,59,59,59,59,26,27,28,29,29,29,62,29,29,29,
29,26,26,26,26,26,26,59,59,59,59,59,59,59,59,59,26,27,26,26,27,28,29,29,62,62,62,62,62,62,
62,59,59,59,59,59,59,59,60,61,62,29,26,26,26,26,26,26,26,27,28,29,29,62,62,62,61,62,26,26,
26,59,60,61,62,62,62,62,62,62,62,26,26,59,59,59,59,59,26,27,28,29,62,59,59,59,59,59,26,27,
26,26,26,59,59,59,59,59,59,60,61,59,59,59,60,61,62,61,59,60,61,62,27,28,29,29,29,29,29,29,
