10,13,9,13,10,9,13,14,13,13,10,14,14,13,14,13,13,14,14,14,10,10,9,10,10,13,13,14,14,10,
9,9,13,14,14,13,13,10,13,13,10,13,13,13,13,14,13,13,13,9,14,10,13,14,10,13,14,13,13,13,
17,18,22,13,13,13,14,13,13,13,10,14,10,13,14,13,13,14,13,10,10,13,13,13,13,14,13,13,13,14,
0,1,16,17,18,17,18,17,18,22,13,13,13,13,13,9,13,13,13,10,14,13,13,13,13,14,23,17,18,17,
27,28,0,0,0,0,0,0,1,16,17,18,17,18,17,18,17,18,22,10,13,13,13,14,23,18,19,0,0,1,
60,28,28,63,61,62,60,28,60,63,60,27,28,29,29,0,0,0,16,17,18,17,18,17,19,0,1,0,3,3,
60,60,60,63,63,28,60,62,62,63,29,27,27,27,28,27,27,27,27,60,60,60,60,60,60,60,60,60,3,3,
27,28,60,60,60,62,60,63,62,62,62,60,60,60,60,60,63,28,28,60,61,62,62,62,62,62,62,62,62,62,
27,28,29,62,29,27,28,27,27,60,61,62,62,27,28,29,28,60,29,63,63,29,29,29,29,29,27,28,29,29,
27,27,27,27,28,60,60,60,63,60,60,61,62,29,29,60,29,29,63,29,29,62,62,62,27,28,29,29,29,62,
60,60,60,60,60,60,63,63,28,29,29,60,61,62,62,62,62,62,29,29,62,27,28,29,60,29,29,63,62,62,
29,60,27,60,61,62,60,60,28,28,63,27,28,29,29,29,60,61,62,62,29,28,29,29,62,62,62,62,60,61,
27,60,27,28,60,61,62,60,60,27,63,63,29,29,62,62,61,60,61,62,62,29,62,62,62,60,61,62,29,61,
60,60,27,28,60,61,62,29,27,28,29,29,62,62,60,61,27,60,28,61,62,62,28,62,62,29,60,61,62,61,
60,61,27,28,60,61,62,62,28,29,29,62,27,60,27,27,60,60,28,62,63,60,62,62,63,27,27,28,29,29,
60,61,60,27,28,60,61,62,28,29,62,27,27,27,60,60,60,60,29,63,63,62,62,60,27,28,29,29,29,62,
60,61,62,28,28,60,61,62,29,29,27,27,60,60,60,60,62,29,63,60,28,28,28,29,29,29,62,62,62,62,
60,61,60,60,27,63,63,62,27,27,60,60,60,61,62,29,29,62,29,60,60,60,63,63,63,62,62,60,61,62,
60,61,62,27,60,60,61,62,60,60,60,61,62,28,29,29,62,27,28,29,29,62,62,62,62,62,27,60,61,62,
60,61,62,28,27,60,61,62,60,61,62,62,29,29,62,27,28,29,29,62,62,61,62,61,62,27,60,60,61,62,
60,61,62,28,60,28,60,61,62,60,61,62,62,27,28,29,29,29,62,61,62,61,62,28,29,27,60,61,62,61,
61,62,27,27,60,28,27,63,60,61,62,62,27,28,29,29,62,62,62,62,62,61,60,28,29,63,60,61,62,61,
61,62,27,27,28,28,27,63,61,62,27,28,29,29,62,62,62,60,61,62,60,28,60,28,29,63,60,61,62,61,
29,60,60,60,60,27,63,63,28,28,28,29,29,62,28,29,62,60,61,62,60,60,60,63,63,63,60,61,62,61,
28,28,28,29,60,60,60,60,60,29,63,63,62,27,28,29,27,60,61,62,27,60,27,28,29,27,60,61,62,61,
60,27,63,63,27,60,61,62,29,29,62,28,27,27,28,29,60,61,62,27,60,27,60,27,28,60,60,61,62,62,
29,27,28,27,60,61,62,29,62,62,27,28,27,27,28,29,60,28,28,27,27,60,60,27,28,29,60,61,62,62,
29,27,27,60,60,61,62,62,61,62,27,28,27,27,28,29,60,60,60,63,63,61,62,27,27,28,60,61,62,62,
29,60,60,60,61,62,62,28,61,62,60,27,27,27,27,27,60,60,60,60,61,62,62,60,27,27,60,61,62,27,
29,27,60,61,62,27,60,61,62,63,62,27,27,60,60,60,60,61,62,61,60,61,62,62,60,60,60,61,62,27,
