9,10,9,10,9,10,10,10,10,9,10,9,9,9,9,9,9,10,10,10,10,9,10,9,10,10,9,10,10,10,
9,9,9,9,9,9,9,9,9,9,9,9,10,10,10,9,9,9,9,9,9,9,10,10,10,9,10,10,9,9,
9,9,9,9,10,9,9,9,9,9,9,9,9,9,9,9,9,9,9,9,9,9,9,9,9,9,9,9,9,10,
17,18,17,18,17,18,17,18,17,22,14,14,14,14,14,23,17,18,17,18,17,18,17,18,17,18,17,18,17,18,
0,0,0,1,2,0,1,2,3,16,17,18,17,18,17,19,0,0,0,0,0,0,0,0,0,0,0,0,1,2,
0,0,0,0,0,0,0,0,0,0,0,0,0,0,0,0,0,1,2,3,3,3,28,62,62,62,59,59,27,27,
27,60,26,0,0,0,0,0,1,2,0,0,1,2,3,29,29,61,28,29,29,61,61,60,60,27,60,59,60,60,
26,26,59,27,60,29,29,29,27,60,29,60,27,27,27,27,27,28,28,29,29,29,29,29,29,60,29,29,29,29,
59,59,26,28,28,28,26,29,29,29,62,26,26,26,26,28,28,28,61,62,62,62,62,62,62,62,62,62,62,62,
59,28,28,61,61,61,29,29,62,62,59,59,59,59,28,28,61,61,27,27,27,27,27,27,27,27,27,27,27,27,
28,61,61,60,27,29,29,62,27,27,62,62,62,29,61,61,28,28,28,29,29,29,29,29,29,29,29,29,29,29,
61,61,27,60,29,29,62,27,60,60,62,60,28,28,28,61,61,61,61,62,29,29,62,62,62,62,29,29,62,62,
62,62,60,29,29,62,60,60,26,27,28,29,61,61,61,61,29,29,29,29,62,62,29,26,26,27,62,62,29,27,
27,27,60,29,62,27,60,60,59,60,61,62,61,62,62,62,62,29,62,62,62,26,26,59,59,29,29,29,62,29,
60,60,60,29,60,28,28,28,28,28,28,62,62,27,62,62,29,62,62,26,26,26,59,59,62,62,62,62,62,29,
62,27,60,29,29,61,61,61,61,61,61,62,29,60,29,29,62,62,62,59,59,59,59,59,62,62,62,62,62,62,
62,60,62,62,29,29,62,28,28,28,61,62,29,29,62,62,29,26,59,62,62,59,62,62,62,62,62,28,28,62,
27,60,60,61,62,29,29,61,61,28,28,28,29,62,62,28,29,59,29,29,29,29,27,27,27,28,29,28,61,27,
60,60,62,26,27,62,62,28,62,61,61,29,62,62,61,29,29,28,62,62,62,62,29,29,29,29,29,61,29,29,
61,62,62,59,26,59,60,61,62,29,29,62,62,59,59,29,62,61,62,62,28,28,62,62,62,62,62,62,62,62,
62,62,27,27,26,59,60,29,29,62,62,59,59,59,29,29,60,60,60,60,61,28,60,60,60,60,60,60,60,60,
27,27,27,27,59,29,29,62,62,29,59,61,60,60,29,29,60,61,62,60,60,28,60,60,60,60,27,27,27,27,
27,60,60,60,29,62,62,29,29,62,60,61,61,62,62,29,60,60,60,60,60,61,60,60,29,27,60,60,60,60,
27,62,62,29,62,62,29,62,62,62,29,29,29,29,29,62,29,29,29,29,29,29,29,29,62,29,29,29,29,29,
27,60,29,62,62,29,62,62,29,29,29,27,62,62,62,62,62,29,29,62,62,62,62,62,27,62,62,29,29,62,
60,27,62,62,62,62,62,62,62,62,62,60,60,61,62,62,62,62,62,62,26,27,28,62,60,61,29,62,29,29,
28,27,62,29,61,62,62,27,27,28,29,62,62,62,26,26,26,29,29,29,26,26,26,29,29,29,62,29,29,29,
61,60,62,62,28,28,62,60,60,61,62,29,29,26,59,29,29,62,62,62,28,59,59,27,29,29,29,29,62,62,
61,61,62,62,61,61,60,60,62,60,61,62,62,59,59,62,62,62,62,28,28,60,29,29,29,62,62,62,29,29,
62,29,29,29,59,59,60,29,29,29,62,62,62,62,62,62,62,62,26,61,61,26,62,62,62,60,60,29,62,62,
