9,10,9,9,9,9,9,10,9,9,9,9,9,9,9,9,9,9,9,9,9,9,9,9,9,9,9,9,9,10,
9,9,9,9,9,9,9,9,9,9,9,10,9,9,10,10,9,9,9,9,9,9,9,9,9,9,9,9,9,10,
17,18,17,18,17,18,17,18,17,18,17,18,17,18,17,22,9,9,9,9,9,9,10,9,9,10,9,9,9,10,
0,1,0,1,0,0,0,0,1,1,0,0,0,1,1,16,17,18,17,18,22,9,9,9,10,23,17,18,17,18,
0,1,0,0,0,0,1,1,0,1,1,1,1,1,2,2,2,2,2,2,16,17,18,17,18,19,2,2,2,2,
0,0,1,0,0,1,1,0,0,1,1,38,38,38,38,2,2,2,2,2,2,2,2,2,2,2,2,2,2,2,
0,0,0,0,1,0,0,0,1,38,39,39,39,39,39,38,38,38,39,38,38,38,38,39,27,27,27,28,28,28,
0,0,0,0,0,0,1,38,38,38,38,38,38,38,39,38,38,38,38,38,39,39,39,60,60,27,28,28,61,28,
0,0,0,1,0,1,38,38,38,38,39,39,39,38,38,38,38,38,38,39,39,38,39,27,28,27,28,61,61,28,
0,1,0,0,0,1,38,38,39,39,38,39,39,39,38,39,39,39,38,38,38,39,27,60,61,27,28,60,61,61,
0,1,0,0,1,38,39,38,38,39,39,39,38,39,39,38,39,38,38,39,38,27,60,60,61,27,28,27,60,61,
0,0,0,1,38,38,38,38,39,39,38,38,38,39,38,38,39,38,39,38,39,60,60,61,44,45,61,27,60,61,
0,0,0,1,38,38,39,39,39,38,38,38,39,38,38,39,38,39,38,39,39,60,61,28,44,45,27,28,60,61,
1,0,1,1,38,39,38,38,38,38,38,38,39,38,38,38,38,39,39,39,27,60,61,61,45,44,44,28,28,28,
1,0,1,1,38,39,38,38,39,38,38,39,39,39,38,38,39,39,38,27,28,27,60,61,28,44,45,45,28,61,
1,0,1,38,39,38,38,38,38,38,39,38,38,38,38,39,39,39,38,27,28,60,60,61,27,28,28,27,27,27,
0,0,1,38,39,39,39,38,39,39,39,38,38,38,38,39,38,38,27,28,27,60,61,61,28,28,44,45,27,28,
0,1,1,38,39,38,39,39,39,38,39,38,39,38,39,38,38,39,27,28,60,60,61,61,28,61,44,28,27,28,
0,1,1,38,38,39,38,38,38,38,38,38,38,39,38,38,38,39,27,27,60,61,61,27,28,61,27,27,27,28,
0,1,1,38,38,39,38,38,38,38,38,38,38,39,38,39,38,38,27,60,61,61,27,28,61,27,27,45,27,28,
0,1,0,1,38,38,39,38,38,38,38,38,38,38,39,38,38,27,60,60,61,61,27,28,61,27,27,45,27,28,
0,1,0,1,38,39,39,38,39,39,38,38,38,38,39,38,39,60,60,61,61,27,28,61,61,60,27,27,27,28,
0,1,0,1,38,39,38,39,39,38,38,38,39,39,39,38,39,60,61,60,61,27,28,60,27,27,45,27,27,28,
0,1,0,1,38,38,38,39,39,38,38,39,39,39,38,38,38,27,28,61,27,28,61,27,60,27,27,45,28,61,
0,1,0,1,38,38,39,39,38,38,38,39,38,39,38,39,27,28,61,27,27,28,28,60,60,27,27,27,27,28,
0,1,0,0,1,38,39,39,38,38,39,39,38,38,39,38,27,28,27,60,27,28,27,60,61,27,27,45,27,28,
0,1,1,0,1,38,39,38,39,39,39,38,39,39,39,27,60,61,60,27,28,61,60,60,61,27,27,27,27,28,
0,1,1,0,1,38,38,39,39,38,38,39,38,38,27,28,28,61,60,27,28,27,60,61,27,28,45,27,27,28,
0,1,1,0,1,38,38,38,38,38,38,38,39,39,27,28,61,60,27,28,27,60,61,61,27,28,27,27,27,27,
0,1,1,1,1,38,39,38,38,38,38,38,38,27,28,28,60,60,27,27,60,60,61,61,27,27,60,27,60,60,
