9,9,10,9,9,9,10,9,9,10,15,2,0,1,2,0,1,2,3,2,3,0,1,2,0,1,2,3,3,0,
9,10,9,9,10,13,14,9,10,10,21,7,0,1,0,0,0,0,1,2,3,0,1,0,1,2,3,3,3,3,
9,10,9,9,13,14,14,9,9,9,10,11,0,1,0,1,2,3,0,0,1,2,3,0,1,2,3,3,3,3,
10,10,9,13,14,14,9,10,10,10,23,19,0,1,2,3,3,3,3,0,0,0,1,2,3,2,3,3,3,2,
13,13,13,14,14,14,9,9,10,23,19,0,1,2,3,3,3,2,3,0,1,0,0,1,2,3,3,2,3,2,
10,13,14,14,10,13,14,9,10,21,6,7,0,1,2,3,1,2,0,1,2,3,0,0,1,2,3,2,3,3,
9,13,14,10,10,13,14,14,10,9,10,11,0,1,2,3,1,2,0,1,2,3,0,0,0,1,2,3,3,3,
9,13,14,10,10,10,9,9,10,23,18,19,0,1,2,3,1,2,0,1,2,3,0,1,0,1,2,3,3,3,
9,9,9,10,10,10,9,9,10,21,7,0,1,2,3,3,3,3,3,3,3,3,0,1,0,0,1,2,3,3,
10,9,10,9,13,14,9,9,10,10,15,0,1,2,3,3,1,0,0,1,2,3,3,3,2,0,1,2,3,3,
10,9,9,9,10,10,10,9,9,10,11,0,1,2,3,3,1,0,1,2,3,0,0,0,1,0,1,2,3,3,
9,9,9,9,10,10,10,9,9,10,11,0,1,2,3,3,2,0,1,2,3,0,0,0,1,0,1,2,3,3,
9,9,10,9,9,10,9,9,10,10,15,0,0,1,2,3,3,0,1,2,3,1,0,0,1,0,1,2,3,3,
9,9,13,14,9,9,10,9,9,10,11,0,0,1,2,3,3,0,1,2,3,1,0,0,1,0,1,2,3,3,
9,10,9,9,9,9,10,9,10,10,15,0,0,1,2,3,3,0,1,2,3,2,3,0,1,0,1,2,3,2,
9,10,9,10,9,13,14,9,10,10,11,0,0,1,2,3,3,0,1,2,3,3,2,0,0,0,1,2,3,2,
9,13,14,9,9,13,14,14,9,10,15,0,0,1,2,3,3,0,1,2,3,3,2,0,0,0,1,2,3,2,
13,14,14,9,13,14,9,9,10,10,21,7,0,0,1,2,3,0,1,2,3,1,2,0,0,0,1,2,3,2,
13,14,9,9,13,14,9,10,9,9,10,15,3,0,1,2,3,3,3,2,3,1,2,3,0,0,0,1,2,3,
9,9,9,9,10,9,9,10,9,9,10,21,6,7,0,0,1,2,3,2,3,1,2,3,0,0,0,1,2,3,
9,9,9,10,10,9,10,9,9,10,10,9,10,15,0,1,2,3,1,2,3,1,2,3,0,0,0,1,2,3,
9,9,9,9,9,10,9,13,14,10,9,9,10,11,0,1,2,3,1,2,3,1,2,3,0,0,0,0,1,2,
9,9,9,9,10,10,10,9,9,10,10,23,18,19,0,1,2,3,0,1,0,1,2,3,2,0,0,1,2,3,
9,9,10,9,9,10,13,14,9,10,10,11,0,1,2,3,2,3,0,1,0,1,2,3,2,0,0,1,2,3,
13,14,13,14,10,10,9,9,9,10,23,19,0,1,2,3,2,3,0,1,0,1,2,3,2,0,1,2,3,3,
9,9,9,9,13,14,9,9,10,23,19,0,1,2,3,3,3,3,3,0,0,1,2,3,0,1,2,3,3,0,
9,9,9,9,9,9,9,10,23,19,0,1,2,3,1,2,3,3,3,0,1,2,3,3,0,1,2,3,0,0,
9,10,9,9,9,9,10,23,19,0,1,2,3,3,3,0,1,2,0,1,2,3,3,3,0,1,2,3,0,0,
9,10,9,9,10,9,10,15,0,0,0,1,2,3,3,3,3,0,1,2,3,3,1,0,1,2,3,0,0,1,
9,10,10,10,10,9,10,11,0,0,1,2,3,1,2,3,3,3,3,0,1,2,3,0,1,2,3,0,1,2,
