2,0,1,2,3,45,44,45,38,39,38,38,39,28,61,61,28,61,27,28,61,61,28,61,28,61,27,28,27,28,
1,0,1,2,44,38,39,38,39,39,39,39,39,61,61,28,28,61,28,28,60,61,61,61,28,61,27,27,28,61,
1,0,1,2,44,38,38,38,38,39,39,27,28,61,61,61,28,61,61,28,61,60,134,135,28,61,27,27,28,61,
1,0,1,2,45,38,39,38,38,39,39,27,28,61,60,61,61,28,61,28,61,60,167,168,28,61,28,27,28,61,
1,0,1,2,45,38,39,38,38,40,41,28,27,28,60,61,28,28,61,61,60,61,167,168,61,61,61,27,28,61,
1,0,1,2,45,38,39,38,38,-1,60,61,28,28,60,61,61,28,60,61,60,27,60,61,61,61,61,28,28,61,
1,0,1,2,45,38,38,39,38,39,27,28,61,27,28,60,61,61,60,61,60,60,60,61,61,61,60,61,28,61,
1,0,0,1,2,45,38,39,38,39,60,61,61,27,28,60,61,61,60,61,60,60,61,60,61,28,60,61,28,61,
1,0,0,1,2,45,38,39,38,39,27,28,61,27,27,28,61,28,60,61,28,60,61,28,60,61,60,61,28,61,
1,0,1,2,2,45,38,39,38,39,60,61,61,60,27,28,28,28,28,60,61,60,61,28,60,61,60,61,28,61,
1,0,1,2,1,2,38,39,38,39,27,28,61,27,28,28,28,61,28,60,61,60,61,28,60,61,60,61,61,61,
1,0,1,2,1,2,38,38,38,39,60,61,61,27,28,61,28,61,61,60,61,60,61,28,60,61,28,60,61,61,
1,2,1,2,2,2,45,38,38,39,27,28,61,27,28,27,28,60,61,28,61,60,61,28,60,61,28,60,61,61,
1,2,1,1,2,39,45,38,38,39,60,61,61,27,28,27,28,60,61,28,61,60,61,28,60,61,27,60,61,61,
1,2,1,1,2,45,38,38,38,38,39,27,28,27,28,27,28,60,61,28,61,60,27,28,28,61,60,60,61,28,
1,2,1,1,2,2,38,38,38,38,39,60,61,28,28,27,28,60,61,28,27,28,27,28,61,61,60,27,60,61,
1,2,1,1,1,2,38,38,39,38,39,39,60,61,27,28,28,60,61,28,27,28,27,28,61,61,60,27,60,61,
1,2,1,1,2,2,38,38,39,38,39,39,27,60,60,61,28,60,61,28,27,28,28,28,61,61,27,60,60,61,
1,2,1,1,2,38,38,38,39,38,39,39,60,27,28,27,28,60,61,27,28,28,61,28,61,28,27,60,60,61,
1,2,1,1,1,2,38,38,39,38,38,39,27,28,28,27,28,60,61,27,28,61,61,61,61,28,27,60,61,28,
1,2,2,1,1,2,38,38,38,38,39,39,60,61,27,60,61,60,61,28,61,27,60,61,61,28,60,60,61,28,
1,2,2,1,1,2,38,39,38,39,39,27,28,28,27,60,61,60,61,28,60,27,60,61,28,27,60,60,61,28,
1,2,2,1,1,2,38,39,38,39,39,60,61,61,27,27,60,61,27,28,28,28,60,61,28,27,60,60,61,28,
2,1,2,2,2,38,38,39,38,39,27,28,27,28,28,28,60,61,28,28,61,61,28,61,28,27,60,60,61,28,
1,2,2,2,2,38,38,38,38,39,60,61,27,28,61,61,61,61,28,61,60,61,61,61,28,27,60,60,61,28,
1,1,2,2,2,39,38,38,39,27,28,27,28,28,61,61,60,61,28,60,61,60,61,28,28,27,60,60,61,28,
1,2,1,2,38,38,38,38,39,60,61,27,28,61,61,61,27,60,61,60,27,60,61,61,61,27,60,60,61,61,
1,1,2,38,38,38,38,39,27,28,27,28,61,60,61,61,60,60,61,60,60,60,60,61,61,28,60,27,60,61,
2,2,38,39,38,38,38,39,27,28,27,28,60,60,61,27,60,61,60,27,60,27,60,61,61,61,60,27,60,61,
2,39,38,38,38,38,38,39,27,28,60,61,60,61,61,27,60,61,28,60,60,60,60,61,60,61,60,27,60,61,
