29,62,27,28,29,29,29,29,29,27,28,27,28,29,29,62,27,27,28,27,28,1,2,3,2,12,13,14,13,14,
29,27,28,29,29,62,62,62,29,27,28,27,28,29,62,62,27,28,29,27,28,60,1,2,4,20,13,13,13,14,
29,27,28,29,62,62,60,61,27,28,27,28,29,29,61,27,27,28,29,27,28,60,1,2,8,14,14,13,13,14,
27,28,29,29,29,62,29,60,27,28,27,28,29,62,27,27,27,28,29,27,28,1,2,3,12,13,14,13,13,14,
27,28,29,62,62,61,62,27,28,27,28,29,27,28,29,27,28,29,29,27,28,1,1,4,20,13,14,14,13,14,
28,29,29,62,60,61,62,27,28,27,28,27,28,29,29,27,28,29,62,27,27,1,2,12,13,14,14,13,14,13,
28,29,62,62,60,61,62,27,27,28,29,27,28,29,62,27,28,29,29,27,60,1,2,8,13,13,14,13,14,13,
28,29,61,62,60,61,27,28,27,28,27,28,29,62,60,27,28,29,62,27,27,1,2,12,14,13,14,14,14,13,
28,29,61,62,60,61,27,27,27,28,27,28,29,28,29,27,28,29,27,27,60,2,2,8,13,13,14,13,14,14,
28,29,29,62,60,61,27,27,28,29,27,28,29,29,27,28,29,62,60,27,60,2,2,12,14,13,14,14,14,14,
28,29,29,62,60,61,60,27,28,27,28,29,62,29,27,28,29,60,61,27,60,61,2,8,13,13,13,14,14,14,
28,29,29,62,60,61,62,27,28,27,28,29,28,29,27,28,29,60,61,27,60,60,2,12,13,14,13,13,14,14,
28,29,28,29,60,61,27,27,27,27,28,29,28,29,27,28,29,60,61,27,60,2,3,8,13,13,14,13,13,14,
27,28,29,28,29,27,27,60,27,27,28,29,28,29,27,28,29,60,61,60,60,2,2,16,22,13,14,13,14,14,
27,27,28,29,27,27,60,27,28,27,28,29,28,29,27,28,29,60,61,62,60,61,2,3,8,13,14,13,13,13,
60,27,27,27,60,60,61,27,28,27,28,27,28,29,29,28,29,60,61,62,60,61,2,2,12,13,14,13,13,13,
28,60,60,60,61,62,27,28,27,27,28,27,28,29,62,29,28,29,29,61,60,61,60,2,8,13,13,14,13,14,
28,29,27,28,27,60,27,28,27,27,28,27,28,29,62,62,29,29,62,29,27,28,29,2,16,22,13,14,13,14,
28,29,27,28,27,60,27,28,27,27,28,27,27,28,29,62,29,62,62,62,29,28,27,60,2,12,14,14,14,13,
28,29,27,28,27,60,27,27,27,28,29,60,27,28,29,61,62,60,61,62,62,29,60,60,2,8,14,14,13,14,
28,29,27,28,27,27,27,28,27,28,29,62,27,27,28,29,62,29,60,61,62,27,60,61,2,12,13,14,14,14,
28,29,27,28,27,27,27,28,27,28,29,28,60,27,27,27,28,29,60,60,27,60,60,61,2,8,13,13,14,14,
28,27,27,28,27,27,28,29,27,27,28,29,29,60,60,27,27,27,27,27,60,60,61,62,2,16,22,13,13,14,
28,60,27,27,27,27,28,29,60,27,28,29,28,27,27,60,60,60,60,60,60,61,62,62,29,2,8,14,13,14,
28,60,60,60,27,27,28,29,62,27,28,29,28,60,27,60,61,62,29,61,27,60,61,62,62,2,16,22,13,14,
28,60,27,60,60,27,28,29,62,27,28,29,27,60,60,60,61,62,29,27,60,27,60,61,62,2,2,8,13,13,
27,60,60,27,27,28,29,62,27,27,28,27,60,60,60,61,62,28,29,60,60,27,60,61,62,27,2,16,22,13,
60,60,61,27,27,28,29,27,60,60,27,60,60,61,62,27,60,27,28,60,61,60,60,61,62,60,60,27,16,17,
60,61,62,27,27,28,29,60,60,61,60,60,61,62,60,27,28,27,27,60,61,62,60,60,60,61,62,60,61,62,
60,61,62,27,27,28,27,60,61,62,62,60,27,60,61,27,27,60,60,60,61,62,62,60,61,62,62,62,62,62,
