27,28,26,27,28,61,61,61,28,28,28,28,28,26,44,27,28,28,28,28,28,28,44,28,28,28,28,28,28,28,
28,26,44,26,26,27,28,61,44,28,61,61,61,26,44,28,28,28,28,28,28,28,28,28,44,28,44,26,27,28,
26,26,26,27,44,27,28,28,61,61,28,61,26,26,27,28,61,26,27,28,61,44,27,28,61,61,61,26,44,28,
27,26,26,26,27,28,44,61,60,61,61,44,59,26,27,44,26,27,44,28,26,27,28,61,26,27,26,27,28,28,
28,26,27,26,27,28,61,61,28,60,61,26,44,27,28,26,27,28,28,61,27,28,61,61,27,28,26,27,28,61,
28,26,27,26,27,28,61,60,61,60,61,59,26,27,26,27,28,28,61,27,28,28,61,27,28,28,26,27,28,61,
61,26,26,27,28,28,61,60,44,59,26,26,27,26,44,28,44,61,61,44,28,61,44,28,61,26,27,28,61,61,
26,27,26,27,28,61,61,60,61,59,59,44,26,27,28,28,26,27,28,28,44,27,28,61,26,26,27,28,60,61,
26,27,26,27,28,60,61,60,61,28,26,26,27,28,28,26,44,27,28,27,44,28,61,26,26,27,28,28,60,61,
26,27,26,27,28,60,61,28,60,44,44,26,27,28,61,26,27,28,28,28,61,61,28,26,27,28,28,28,60,61,
27,28,26,27,28,59,60,61,60,26,26,27,28,61,59,44,27,28,61,28,28,28,61,28,27,28,61,61,60,61,
27,28,26,27,28,59,60,61,26,26,27,28,28,26,27,28,28,61,60,61,28,61,60,61,27,28,60,61,60,61,
27,26,27,28,61,59,60,61,26,26,27,26,27,28,28,28,61,28,60,61,28,61,60,61,28,28,60,61,28,61,
28,26,27,28,26,59,60,26,26,27,26,27,28,28,61,61,61,61,59,60,61,61,28,60,61,28,59,60,61,28,
28,26,27,28,59,59,60,26,27,26,27,28,28,61,27,59,60,61,28,60,61,28,61,60,61,28,59,60,61,61,
28,26,27,28,28,59,26,26,26,27,28,28,61,26,27,28,59,60,61,60,61,61,61,60,61,28,59,60,61,28,
28,26,27,28,28,26,26,26,27,28,28,61,59,26,27,28,59,60,61,59,60,61,61,59,60,61,59,60,61,61,
28,26,27,28,26,26,26,26,27,28,61,60,26,27,28,61,59,60,61,59,60,61,61,59,60,61,28,59,60,61,
28,26,27,28,26,27,26,27,28,61,59,60,26,27,28,26,27,28,28,28,26,27,28,59,60,61,61,59,60,61,
28,26,27,26,26,26,26,27,28,61,60,61,26,26,27,28,28,28,26,27,28,28,61,59,60,61,61,28,60,61,
28,26,26,26,59,26,27,28,28,59,60,61,26,27,26,27,28,28,28,28,28,61,61,28,60,61,60,61,60,61,
28,26,27,59,59,26,27,28,61,61,61,26,27,28,28,28,61,61,61,61,61,60,109,110,60,61,60,61,28,61,
27,26,27,28,44,26,27,44,60,26,27,28,28,28,61,61,27,28,59,60,61,61,142,143,60,61,60,61,61,61,
27,26,27,26,59,26,27,28,26,27,28,28,61,61,26,27,28,26,59,60,61,61,60,61,60,61,59,60,61,61,
27,26,44,59,59,26,26,26,27,28,28,28,28,28,27,28,26,59,59,60,61,59,60,61,60,61,59,60,61,61,
44,59,59,60,26,27,28,28,28,28,61,61,61,61,28,26,59,59,60,61,59,59,60,61,60,61,59,60,61,28,
26,26,27,28,44,28,28,44,61,61,59,60,61,26,26,59,59,60,61,26,59,60,61,59,60,61,28,59,60,61,
28,28,28,28,44,26,26,26,26,27,28,26,26,59,59,60,61,26,59,59,60,61,61,59,60,61,27,59,60,61,
26,26,26,26,59,59,59,59,59,60,61,59,59,59,60,61,26,59,59,60,61,61,59,59,60,61,27,59,60,61,
59,59,44,59,60,61,59,59,59,59,59,59,60,61,26,59,59,59,60,61,60,61,59,60,61,59,26,59,60,61,