9,10,9,10,9,10,9,10,27,28,29,29,29,29,29,27,27,28,29,29,62,27,28,29,62,61,28,29,29,28,
9,10,9,9,10,9,10,10,60,61,62,62,28,28,29,28,29,29,29,62,28,29,29,29,29,29,29,27,28,29,
9,10,9,9,10,9,10,62,27,27,28,29,28,29,27,28,29,29,62,61,28,29,62,28,28,28,29,27,28,29,
9,10,9,9,10,9,10,62,28,28,29,29,61,62,28,29,29,62,61,62,62,29,62,27,27,28,29,28,29,62,
9,10,9,9,9,10,10,28,29,29,29,28,29,28,29,29,62,61,62,62,29,29,61,62,28,29,29,29,29,29,
9,10,9,9,9,10,28,29,60,27,28,29,29,29,29,62,61,62,27,28,29,62,27,27,28,27,29,29,62,29,
9,10,9,10,9,10,28,28,28,29,62,62,62,62,62,62,62,27,28,29,62,27,60,28,28,29,29,62,28,29,
9,9,10,9,10,10,28,28,29,62,62,62,28,28,28,61,62,62,29,62,27,60,62,61,28,29,62,62,28,29,
9,9,10,9,10,29,28,29,62,62,29,62,61,61,61,27,61,45,45,45,60,28,28,28,28,29,29,62,29,29,
9,9,10,9,10,62,62,61,62,29,62,28,29,61,62,27,61,45,45,45,27,27,27,28,28,29,28,28,29,29,
9,9,10,9,10,62,29,29,62,62,27,28,28,29,27,29,29,45,45,62,60,60,27,28,28,28,29,29,29,29,
9,9,10,9,10,29,29,62,27,60,60,60,28,28,29,27,27,27,45,27,27,27,27,27,27,28,29,28,29,29,
9,9,10,9,10,29,62,27,60,61,28,29,61,28,45,60,60,45,60,60,60,45,60,60,60,28,29,28,29,29,
9,9,10,9,10,29,27,60,61,62,28,29,38,45,38,45,39,39,39,39,39,39,39,39,62,28,29,29,28,29,
9,9,10,9,10,62,60,60,61,62,27,28,45,45,45,39,45,45,45,45,39,39,45,39,29,28,29,29,28,29,
9,9,9,10,10,27,60,61,62,27,28,29,38,39,45,38,38,45,45,39,39,45,45,39,29,28,29,29,61,28,
9,9,9,10,10,60,61,62,27,28,29,62,38,39,38,38,38,38,45,45,38,39,45,39,29,28,29,29,61,28,
10,9,9,10,10,27,28,62,28,29,62,62,38,39,38,38,38,38,39,38,45,45,45,39,29,28,29,62,61,62,
10,9,9,10,10,60,61,28,28,29,62,28,38,39,38,39,38,38,38,39,45,39,38,39,27,28,29,60,61,62,
10,9,9,10,10,10,27,28,61,28,62,29,38,45,45,39,38,38,38,39,45,45,45,39,61,28,28,29,61,62,
10,9,9,10,10,9,27,28,61,61,27,28,38,45,45,45,38,38,38,39,45,45,45,39,61,28,29,29,60,61,
10,10,9,10,10,9,27,28,60,61,28,28,38,45,45,45,38,38,38,38,38,45,38,39,28,29,28,29,60,61,
10,10,9,10,10,10,27,27,28,61,61,61,38,38,38,45,45,38,45,45,45,45,38,39,29,28,28,29,60,61,
10,10,9,10,10,9,60,27,28,60,61,27,28,29,38,60,38,60,60,45,45,60,28,29,27,28,28,29,60,61,
10,10,9,10,10,10,10,27,27,28,61,29,29,62,62,61,61,62,27,28,28,29,60,60,27,27,28,29,60,61,
10,10,9,9,10,9,10,60,27,27,28,62,62,29,60,27,28,28,28,29,29,62,62,60,60,27,28,29,60,61,
10,10,9,9,10,9,10,10,60,27,28,28,28,28,28,28,28,29,29,62,62,61,62,27,27,27,28,29,60,61,
10,9,9,10,10,9,10,10,27,27,27,28,29,60,27,28,29,29,62,61,62,61,62,60,27,60,28,29,60,61,
9,10,9,10,9,9,10,13,14,60,27,28,27,27,28,29,29,62,60,61,62,61,62,60,27,28,28,29,60,61,
9,9,9,10,9,10,9,13,13,14,27,27,28,29,29,62,62,27,60,61,62,61,62,60,27,27,27,28,29,61,