27,27,27,27,27,27,27,27,27,27,27,27,27,27,27,27,27,27,27,27,27,27,27,27,27,27,27,27,27,27,
60,60,60,60,60,60,60,60,60,60,60,60,60,60,60,60,60,27,28,29,29,29,29,29,29,29,29,29,29,29,
39,39,27,27,27,27,27,27,27,27,28,29,29,29,29,29,29,29,29,62,62,62,62,62,62,62,62,62,62,62,
27,27,27,27,27,27,27,27,27,27,27,27,27,28,29,29,29,29,29,29,29,29,29,29,29,29,29,29,29,29,
27,27,27,27,27,27,27,28,29,60,60,60,60,27,27,27,27,27,27,27,27,27,27,27,27,27,27,27,27,27,
60,60,60,60,60,60,60,27,27,27,27,27,27,27,27,27,27,27,27,27,27,27,27,28,29,29,29,29,29,29,
29,29,29,29,39,29,29,29,29,29,29,29,29,29,29,29,29,29,29,29,29,29,29,29,29,29,29,29,29,29,
27,27,27,27,39,39,39,27,27,27,27,27,27,39,27,27,27,27,27,27,27,27,27,27,27,27,27,27,27,27,
60,60,60,60,60,39,39,60,60,60,60,60,39,39,60,27,28,29,29,29,29,29,29,29,29,29,29,29,29,29,
27,27,27,27,27,27,27,27,27,27,27,27,27,27,27,27,27,27,27,27,27,27,27,27,27,27,27,27,27,27,
60,60,60,60,60,27,28,29,29,29,29,29,29,29,29,29,29,29,29,29,29,29,29,29,29,29,29,29,29,29,
29,29,29,29,29,29,29,62,62,62,62,62,62,62,62,62,62,62,62,62,62,62,62,62,62,62,62,62,62,62,
29,29,29,29,29,29,29,29,29,29,29,29,29,29,29,29,29,29,29,29,29,29,29,29,29,29,29,29,29,29,
62,39,62,62,62,62,62,62,62,62,62,62,62,62,62,62,62,62,62,62,62,62,62,62,62,62,62,62,62,62,
39,39,27,27,27,39,27,27,27,27,27,27,27,27,27,27,27,27,27,27,28,29,29,29,29,29,29,29,29,29,
29,29,29,29,29,29,29,29,29,29,29,29,29,29,29,29,29,29,29,29,29,62,62,62,62,62,62,62,62,62,
27,27,27,27,27,27,27,27,27,27,27,27,27,27,27,27,27,27,27,27,27,27,27,27,27,27,27,27,27,27,
60,27,28,29,29,29,29,29,29,29,29,29,29,29,29,29,29,29,29,29,29,29,29,29,29,29,29,29,29,29,
27,27,27,27,27,27,27,27,27,27,27,27,27,28,29,29,29,29,29,29,29,29,29,29,29,29,29,29,29,29,
60,60,60,27,28,29,29,29,29,29,29,29,29,29,62,62,62,62,62,62,62,62,62,62,62,62,62,62,62,62,
29,29,29,29,29,62,62,62,27,27,27,27,27,27,27,27,27,27,27,27,27,27,27,27,27,27,27,28,29,29,
27,27,27,27,27,27,27,27,60,60,60,60,60,60,60,60,60,60,60,60,60,60,60,60,60,27,28,29,29,29,
27,27,60,60,60,60,27,27,27,27,27,27,27,27,27,27,27,27,27,27,27,27,27,27,27,27,27,27,27,27,
27,27,27,27,27,27,60,60,60,60,60,60,60,60,60,60,60,60,60,60,60,60,60,60,60,60,60,60,60,60,
60,60,60,60,60,60,61,62,29,29,29,29,29,29,29,29,29,62,62,62,62,62,62,27,28,29,29,29,29,29,
60,61,62,29,29,29,62,62,62,62,62,62,62,62,27,28,27,27,27,27,27,27,27,27,27,27,27,27,28,29,
61,60,61,62,27,27,27,27,27,27,27,27,27,27,27,27,60,60,60,60,60,60,27,27,27,27,27,27,27,27,
27,27,27,27,27,27,27,27,27,27,27,27,27,27,27,27,27,27,27,27,27,27,27,60,60,60,60,60,60,27,
27,27,60,60,60,60,60,60,60,60,60,60,60,60,60,60,60,27,27,27,27,27,27,27,27,27,27,28,29,29,
27,27,27,27,27,27,27,27,27,27,27,27,27,27,27,27,27,60,60,60,60,60,60,60,60,60,60,61,62,62,