29,29,29,29,29,29,29,29,29,29,29,29,29,29,29,29,29,60,60,60,60,27,28,29,29,29,28,29,29,29,
62,62,62,62,27,28,29,29,29,29,29,29,29,29,29,29,62,29,29,29,44,29,44,29,62,62,27,28,29,62,
29,29,29,27,28,29,29,62,62,62,62,62,62,62,62,27,27,27,27,28,29,27,27,27,27,28,29,28,29,28,
27,28,27,28,29,29,62,61,62,27,27,28,29,27,27,60,60,60,27,44,29,44,60,60,27,28,29,27,28,29,
28,29,27,28,29,62,60,61,27,27,28,27,27,27,27,27,27,27,27,27,28,29,29,62,27,28,27,28,29,29,
29,27,28,27,28,29,29,29,29,29,27,27,27,27,27,60,27,27,60,44,28,29,62,27,28,29,27,28,29,62,
27,28,27,60,27,27,27,27,27,27,60,60,60,60,60,27,60,60,61,27,27,44,29,29,28,29,27,28,29,62,
27,27,60,60,60,60,60,60,60,60,60,61,62,27,27,60,60,61,44,60,27,27,28,29,28,29,27,28,29,62,
60,60,61,62,29,29,29,29,29,27,60,61,27,60,60,44,118,118,29,44,60,27,27,28,29,29,27,28,29,62,
62,29,29,29,62,62,62,27,27,27,28,29,29,29,118,44,29,29,44,29,44,29,29,29,28,29,27,28,29,62,
62,62,62,62,27,27,27,28,27,28,29,29,29,60,44,29,44,29,44,118,62,62,62,62,29,29,29,28,29,62,
27,60,60,27,28,29,27,27,28,29,29,62,118,62,62,62,44,62,62,62,118,29,61,62,62,62,29,29,29,29,
60,27,28,29,29,27,27,28,29,29,62,62,118,62,44,44,44,27,44,44,118,29,29,60,61,62,62,62,29,62,
28,29,29,27,27,27,28,29,29,62,60,60,44,27,44,27,28,29,44,29,118,27,27,27,27,27,28,29,62,62,
29,29,27,27,28,29,29,29,27,27,27,28,27,118,27,27,27,44,27,118,28,29,29,27,28,29,29,29,62,62,
27,27,27,28,27,27,27,28,27,27,27,27,60,60,118,44,44,60,44,27,27,27,27,27,27,28,29,29,29,62,
27,27,27,27,27,27,27,27,60,60,60,60,61,62,44,118,60,118,61,60,60,60,60,60,27,28,29,62,62,29,
27,60,60,60,60,60,60,60,61,62,60,60,60,61,62,60,60,27,27,27,60,60,60,60,60,27,28,29,62,62,
60,60,61,62,27,28,27,28,27,27,28,29,27,28,29,27,27,28,29,27,28,29,27,28,29,27,28,29,28,29,
61,27,28,29,27,28,29,27,28,29,29,27,28,2,2,2,27,28,29,27,28,29,27,28,29,27,28,29,28,29,
62,60,61,62,60,61,62,60,61,62,62,2,2,2,2,2,2,2,62,60,61,62,60,60,60,60,61,62,61,62,
60,60,60,60,25,0,1,3,3,3,4,5,6,5,6,5,7,0,0,0,2,60,60,60,60,60,60,60,60,60,
60,28,28,0,0,1,1,2,4,5,20,9,9,9,9,10,21,7,0,0,0,0,0,1,0,1,60,60,60,60,
28,28,1,0,0,0,1,4,20,9,9,9,9,10,10,9,10,21,7,0,1,3,0,0,1,2,3,3,60,60,
28,1,0,0,2,4,5,20,9,9,9,10,10,10,10,9,9,10,21,6,5,6,7,3,3,0,0,1,3,60,
2,2,4,6,5,20,9,9,9,9,10,10,10,9,10,9,10,10,9,9,9,10,21,6,7,3,3,3,3,3,
6,5,20,9,9,9,9,9,10,9,10,9,10,10,10,9,10,10,10,10,10,9,9,10,21,6,5,6,7,3,
9,9,10,9,10,10,10,10,9,10,10,9,10,10,9,9,10,10,10,9,10,10,9,9,10,9,9,10,21,6,
9,10,9,10,10,10,10,9,9,10,9,10,10,9,9,10,10,9,10,10,10,10,10,10,10,10,9,9,9,9,
9,10,9,9,9,9,9,9,9,9,9,9,9,9,9,9,9,10,10,9,9,9,9,9,10,10,10,10,10,10,
