14,9,10,13,9,9,10,14,13,14,27,27,27,28,29,62,27,28,29,27,28,29,29,29,29,29,62,29,29,29,
14,9,13,13,9,13,10,13,14,14,27,28,28,27,27,27,28,29,27,28,29,29,62,29,29,62,29,29,29,28,
9,10,13,10,9,13,14,13,14,0,60,27,28,28,28,27,28,27,28,29,29,62,62,62,62,62,62,62,62,29,
9,13,10,9,9,13,10,13,14,0,1,60,61,61,61,28,29,27,28,29,62,62,60,61,62,29,61,62,29,29,
9,13,10,9,10,9,10,13,14,0,1,2,27,60,61,28,29,27,28,29,62,62,27,60,61,62,60,61,62,29,
9,13,14,9,10,9,10,13,14,0,1,2,60,60,61,28,29,27,28,29,29,27,28,29,29,62,29,61,62,62,
9,13,10,9,10,9,10,13,14,0,1,2,60,61,27,28,27,28,29,29,27,27,28,29,62,29,62,60,61,62,
9,10,9,10,14,14,14,13,14,0,1,2,60,61,27,28,27,28,29,62,27,28,29,29,62,27,28,29,60,61,
9,10,13,14,14,14,14,13,14,0,1,2,60,61,28,28,27,28,29,27,27,28,29,62,61,27,28,29,29,61,
9,10,13,13,14,14,14,14,14,0,1,2,60,61,61,61,27,28,29,27,27,28,29,60,27,27,28,29,29,29,
10,9,10,14,14,14,14,13,14,0,1,2,60,61,60,61,27,28,29,27,27,28,29,61,27,27,28,29,62,29,
10,9,10,14,13,14,14,13,14,0,1,2,60,61,61,28,60,27,28,27,27,28,29,60,27,28,29,29,61,62,
10,9,9,14,13,13,14,13,14,0,1,2,2,60,61,27,27,27,28,27,27,28,27,28,29,29,29,62,60,61,
10,9,9,14,13,13,14,13,14,0,0,1,2,60,61,27,60,27,28,27,27,28,27,28,29,62,62,29,60,61,
9,10,9,14,13,13,13,14,13,14,0,1,2,2,61,28,27,27,27,27,27,28,27,28,29,61,62,62,29,60,
9,10,10,13,13,13,13,14,13,14,0,1,2,2,2,61,28,28,27,27,27,28,27,28,29,60,61,62,62,60,
9,9,10,13,13,13,13,14,13,14,0,1,2,2,2,2,2,61,28,28,27,28,27,28,29,27,28,29,29,29,
14,9,13,13,9,10,9,9,10,13,14,0,1,2,2,2,2,2,28,28,28,28,27,28,27,28,29,29,62,62,
14,9,13,9,9,10,9,10,10,13,13,14,0,1,2,2,2,2,61,28,61,28,27,28,27,28,29,62,60,61,
14,9,13,9,10,9,10,14,14,10,13,13,14,0,1,2,2,2,2,28,61,27,27,27,27,28,29,60,60,61,
14,13,13,13,10,9,9,10,14,14,14,13,13,14,0,1,2,2,2,2,61,27,60,27,27,28,29,60,60,61,
14,13,10,13,9,10,14,14,9,14,14,9,10,13,14,0,1,2,2,2,2,28,27,27,28,29,29,60,27,28,
13,13,10,13,14,9,10,14,14,9,10,10,13,13,13,14,0,1,2,2,2,2,60,27,28,29,62,29,60,61,
14,9,13,13,13,9,9,13,14,14,9,9,10,9,10,13,14,0,1,2,2,1,2,27,28,29,27,27,27,60,
9,9,10,10,13,14,13,13,10,14,14,9,9,10,10,13,13,14,0,1,2,2,1,1,2,28,29,60,60,60,
14,14,14,14,14,14,13,10,10,13,13,14,14,9,9,10,13,13,14,0,1,1,2,1,1,2,29,27,60,61,
13,10,14,14,14,14,14,13,9,10,14,14,14,13,14,14,9,10,13,14,0,1,2,2,1,1,2,60,60,61,
13,13,13,9,14,14,14,13,13,10,10,9,10,13,13,10,9,10,13,13,13,14,2,3,2,2,1,2,1,2,
10,14,13,10,10,14,13,9,13,13,14,14,9,10,10,13,13,9,10,10,10,13,13,13,13,9,9,9,9,10,
10,9,10,10,14,9,10,10,9,13,13,14,14,14,14,13,13,13,13,9,10,10,9,10,13,13,14,9,10,10,
