28,29,29,27,28,29,62,27,60,60,61,62,62,27,27,28,29,62,60,61,62,62,29,29,29,29,29,60,61,62,
29,29,29,29,29,29,29,29,29,29,29,29,29,29,29,29,62,29,29,60,61,62,62,62,27,27,28,29,61,62,
62,62,62,62,62,62,62,62,62,62,29,29,29,29,29,29,29,29,29,29,29,61,62,29,60,27,28,29,62,60,
29,29,27,27,27,27,27,27,60,61,62,62,62,62,62,62,62,62,29,29,29,29,29,27,27,27,28,29,27,27,
27,27,27,27,27,27,27,27,28,29,60,60,60,60,60,60,60,27,27,27,27,27,27,27,27,27,28,29,27,27,
60,60,60,60,60,60,60,60,27,27,27,27,27,27,27,27,27,60,60,60,60,60,60,60,60,27,28,29,29,60,
28,29,61,62,61,62,61,62,60,60,60,60,60,60,60,60,60,61,62,60,60,61,62,62,27,27,28,29,62,62,
28,29,61,62,27,28,29,29,29,29,27,27,27,60,60,60,60,61,62,60,60,61,27,27,27,27,28,29,62,29,
28,29,27,28,29,29,62,62,27,27,60,60,60,27,28,29,29,29,29,29,29,29,29,29,29,27,28,29,62,62,
27,28,29,29,62,27,27,27,60,60,27,28,29,29,29,62,62,62,62,62,62,62,62,62,62,29,29,29,61,62,
28,29,27,27,27,60,60,60,61,27,28,29,29,62,62,29,29,62,61,62,27,27,27,27,28,29,62,62,29,29,
27,27,28,29,29,29,29,29,29,29,29,29,29,29,29,29,27,27,27,27,60,60,60,27,28,29,29,61,62,62,
29,29,29,29,62,62,62,62,62,62,62,62,62,62,62,62,29,29,29,29,29,29,29,29,29,29,62,62,60,61,
28,29,62,62,27,27,27,27,27,27,60,60,60,60,61,62,62,62,62,62,62,62,62,62,62,62,29,29,29,29,
27,27,27,27,27,27,27,27,27,27,27,27,27,27,27,27,27,27,27,27,28,29,62,62,62,62,62,62,62,62,
60,60,60,60,60,60,60,60,60,60,60,60,60,60,60,60,60,60,60,60,27,27,27,27,27,27,27,28,29,61,
61,62,27,28,29,29,29,29,29,29,29,29,29,29,29,29,29,29,27,60,60,60,60,60,60,60,60,27,27,27,
27,27,27,27,27,27,27,27,27,27,27,27,27,27,27,27,27,27,27,27,27,27,27,27,27,27,27,27,28,29,
29,29,29,29,29,29,29,29,29,29,29,29,29,29,29,29,29,29,29,29,27,27,27,27,27,27,27,27,28,29,
27,28,29,27,27,27,27,27,27,27,27,27,27,27,27,27,27,27,27,27,28,29,29,29,27,27,27,28,29,29,
27,27,27,27,28,29,29,29,29,29,29,29,29,29,29,60,60,27,28,29,27,27,27,27,60,60,27,27,28,29,
27,28,29,27,27,28,29,62,27,28,29,29,62,62,62,29,29,29,29,29,60,60,60,60,60,61,60,27,28,29,
27,28,29,60,27,27,28,1,2,2,2,2,2,2,2,2,2,1,1,2,27,28,29,29,29,29,29,27,28,29,
27,28,27,28,29,1,1,1,1,1,1,1,1,2,0,0,1,2,2,1,1,1,1,2,62,62,62,27,28,29,
60,61,1,1,1,1,2,0,0,0,1,4,5,6,5,6,5,6,5,7,0,0,1,1,1,1,1,2,61,62,
29,2,2,2,0,0,0,4,5,6,5,20,9,9,9,9,9,9,10,21,6,5,6,7,2,2,1,2,1,2,
0,2,0,4,5,6,5,20,9,9,9,9,9,10,9,9,9,10,9,9,9,9,10,21,6,5,6,5,6,5,
5,6,5,20,9,9,9,10,10,10,10,10,10,10,10,10,10,10,10,10,10,10,9,9,9,9,9,9,9,10,
9,10,9,9,9,10,10,9,9,10,10,10,9,9,9,9,9,10,10,10,10,10,10,10,10,10,10,10,10,10,
9,10,9,10,9,9,9,9,9,9,9,9,9,9,9,9,9,9,10,10,10,10,10,10,10,10,10,10,10,10,
